1000000000
1111111100
0000200000
0000222200
0000000000
