0,0,0,0,0,0,0,0,0,0,0,0,0,0,0,0,0,0,0,0,0,0,0,0,0,0,0,0,0,0,0,0,0,0,0,0,0,0,0,0,0,0,0,0,0,0,0,0,0,0
0,0,0,0,0,0,0,0,0,0,0,0,0,0,0,0,0,0,0,0,0,0,0,0,0,0,0,0,0,0,0,0,0,0,0,0,0,0,0,0,0,0,0,0,0,0,0,0,0,0
0,0,0,0,0,0,10,10,10,7,0,0,0,7,0,0,0,0,0,0,10,10,0,0,0,0,10,0,0,0,0,0,0,0,0,0,0,0,0,0,10,0,0,10,10,0,0,0,0,0
0,0,0,0,10,10,10,25,10,10,10,10,10,7,0,0,0,0,0,10,10,10,10,0,10,10,10,0,10,10,0,0,0,0,0,0,10,10,10,0,10,10,10,10,7,10,0,0,0,0
0,0,7,7,10,7,7,10,7,7,10,7,10,10,4,10,0,0,0,10,1,1,10,10,10,25,10,10,10,10,0,0,0,10,10,10,10,1,10,10,10,10,7,7,7,7,0,0,0,0
0,0,0,10,10,10,7,10,10,10,4,4,4,10,4,10,10,10,10,10,10,1,1,10,10,10,10,10,10,10,10,1,10,10,10,1,1,10,10,10,7,7,10,10,10,7,10,10,0,0
0,0,0,10,7,10,10,10,4,4,4,10,4,10,10,10,10,7,7,7,10,1,1,1,10,1,10,10,4,4,10,10,10,4,10,10,10,10,7,10,10,10,10,7,10,10,10,25,0,0
0,0,10,10,7,2,2,2,4,10,10,10,10,10,7,7,10,10,10,7,10,10,10,10,10,10,10,10,4,4,4,4,4,4,4,4,10,4,7,4,4,4,4,7,10,10,10,7,0,0
0,0,0,25,2,2,7,4,4,10,7,7,7,7,7,2,2,7,7,7,2,2,7,7,2,2,10,10,10,10,10,4,4,10,10,10,10,10,10,10,10,7,4,4,4,7,10,10,0,0
0,0,2,2,7,2,2,4,2,2,2,2,2,2,7,7,2,2,2,7,7,2,2,2,2,2,2,2,2,4,10,10,10,10,4,2,2,10,7,7,10,10,10,10,4,10,10,0,0,0
0,0,2,4,4,4,2,2,7,7,7,7,7,2,2,7,7,7,2,2,2,7,7,7,7,2,2,2,2,2,2,4,4,4,4,2,7,10,10,10,7,7,7,10,10,2,2,2,0,0
0,0,2,2,2,4,4,2,7,2,2,2,2,2,7,7,2,2,2,7,7,2,2,2,2,2,2,2,4,4,2,2,2,2,4,2,7,7,7,7,7,2,2,2,10,2,7,2,0,0
0,0,0,7,2,2,4,2,2,2,7,2,7,2,2,7,2,4,2,2,2,4,4,4,4,2,2,2,2,4,4,4,4,2,2,2,7,2,2,2,2,2,4,2,10,2,7,7,0,0
0,0,0,7,7,2,4,4,4,4,4,2,4,2,7,7,2,4,4,4,4,4,2,2,2,2,2,2,2,2,2,2,4,4,4,2,2,2,7,7,2,4,4,2,2,2,2,3,0,0
0,0,2,2,2,2,2,2,2,2,2,7,4,2,2,2,2,2,2,2,2,4,2,7,7,2,2,2,2,4,4,2,4,2,2,2,4,4,4,4,4,4,3,3,3,3,3,3,0,0
0,0,25,7,2,4,4,4,4,4,2,2,2,7,7,7,7,7,2,4,2,2,2,7,2,2,2,2,4,4,2,2,2,2,2,2,4,4,3,3,3,3,3,7,3,7,7,0,0,0
0,0,3,3,7,2,2,2,2,2,2,4,2,2,2,2,2,2,2,4,7,7,7,7,2,3,3,3,3,4,2,7,7,2,7,2,2,2,7,7,7,7,3,7,3,7,3,0,0,0
0,0,4,3,7,2,4,4,4,4,2,4,2,4,4,4,4,4,4,7,2,2,2,2,2,4,4,3,3,3,4,2,2,2,7,3,3,3,7,4,4,3,3,3,7,7,3,0,0,0
0,0,4,3,3,3,3,3,4,2,2,4,4,4,2,2,2,2,2,2,2,4,3,4,4,3,3,3,3,3,3,7,3,3,3,3,7,3,3,3,3,3,7,3,3,3,3,3,0,0
0,0,4,4,4,4,4,3,4,2,4,4,2,4,2,3,3,3,4,4,2,4,3,3,3,3,3,4,3,3,3,3,3,7,7,3,7,7,7,7,7,7,7,7,7,7,7,3,0,0
0,0,3,3,4,4,3,3,3,3,3,4,2,2,2,7,7,3,3,3,3,3,3,4,4,4,3,3,3,3,3,7,3,3,7,3,3,4,7,7,3,3,3,3,3,3,7,3,0,0
0,0,25,3,3,4,4,3,4,7,3,3,3,3,3,3,7,7,7,3,7,7,7,7,3,3,3,3,3,3,3,3,7,4,4,4,7,4,3,3,3,7,7,7,7,3,7,7,0,0
0,0,7,4,3,3,3,3,4,4,4,4,4,4,7,3,3,3,7,7,7,3,3,4,4,3,3,3,3,7,7,3,3,3,7,7,3,3,3,7,3,3,3,3,7,3,3,3,0,0
0,0,0,3,3,4,4,4,1,1,1,7,7,4,4,4,4,3,3,3,3,3,3,3,3,1,1,1,1,1,1,1,4,3,3,3,3,7,7,4,7,7,7,3,3,7,7,25,0,0
0,0,0,7,7,7,7,7,4,4,1,1,1,1,1,7,7,4,4,7,3,7,7,7,1,1,1,1,7,7,7,1,4,4,7,4,4,7,7,4,1,1,1,1,3,7,1,7,0,0
0,0,7,1,1,1,1,7,7,7,7,7,7,7,1,1,1,1,1,7,7,7,1,1,1,1,1,1,1,7,7,1,1,4,4,4,1,1,1,1,1,7,7,1,7,1,1,7,0,0
0,0,1,1,7,7,1,1,1,1,1,1,7,7,7,7,7,7,1,1,1,1,1,7,1,7,1,1,1,1,7,7,1,1,1,1,1,7,7,7,1,7,4,1,1,1,4,7,0,0
0,0,25,4,4,4,4,4,4,7,7,1,1,1,1,7,7,7,7,7,7,7,7,1,1,1,1,1,4,4,7,4,4,4,4,4,4,4,1,1,1,7,4,4,4,4,4,7,0,0
0,0,4,1,1,1,1,7,4,4,4,4,4,7,1,1,1,1,1,1,1,1,7,1,1,1,1,1,1,4,4,4,7,7,7,7,4,1,4,4,4,4,4,1,1,1,4,25,0,0
0,0,1,1,7,7,1,1,1,1,7,7,4,4,4,4,4,4,1,4,4,1,1,7,1,1,1,1,1,1,1,1,1,1,1,1,4,1,7,1,1,1,1,1,7,1,1,1,0,0
0,0,0,7,7,4,4,4,4,1,1,1,1,1,1,1,1,4,4,4,1,1,1,1,1,1,1,1,4,4,4,4,4,4,4,1,1,1,1,1,7,7,7,7,7,7,7,0,0,0
0,0,1,1,7,4,1,1,1,1,7,7,7,7,7,7,1,1,1,1,1,7,7,1,1,1,25,1,1,1,1,1,1,7,4,4,1,4,4,1,7,7,1,1,1,1,1,0,0,0
0,0,0,1,7,7,0,7,7,7,7,1,1,1,1,7,7,7,1,7,7,7,1,1,1,1,1,1,1,4,4,4,1,1,1,4,4,4,1,1,1,1,1,7,7,7,0,0,0,0
0,0,0,1,0,0,0,7,1,1,1,1,7,7,1,1,1,1,1,7,1,1,1,1,1,0,0,0,1,1,1,4,1,7,1,1,1,4,4,1,7,7,1,1,1,0,0,0,0,0
0,0,0,0,0,0,0,0,0,0,0,0,0,0,0,0,0,0,0,0,0,0,0,0,0,0,0,0,0,0,0,0,0,0,0,0,0,0,0,0,0,0,0,0,0,0,0,0,0,0
0,0,0,0,0,0,0,0,0,0,0,0,0,0,0,0,0,0,0,0,0,0,0,0,0,0,0,0,0,0,0,0,0,0,0,0,0,0,0,0,0,0,0,0,0,0,0,0,0,0
